1111111111111
1E010000000C1
1000C11111101
1C00111P000C1
1111111111111
